1111111111111111
1XXXXXXX1XXXXXX1
1.......1......1
1.P.....1....E.1
1.......1......1
1.......1......1
1.......1......1
1.......1......1
1.......1......1
1..............1
1.......1......1
1.......1......1
1.......1......1
1.......1......1
1.......1......1
1XXXXXXX1XXXXXX1
1111111111111111