111111111111111111111111
1......................1
1.1111111.111111111111.1
1.11......1............1
1.11.1111.111111111.1111
1.11.1111.1111111......1
1.11.1111.........1.11.1
1.........111111111.11.1
1.1111111.11...........1
1.1.......11111111111111
1.1.1111111E...........1
1.1.......111111111111.1
1.1111111..............1
1.........11111111111111
1.11111.1..............1
1.....1.111111111111.1.1
11111.1..............1.1
1.111.111111111.1111.111
1.1.....1..............1
1.11111.1111111.11.111.1
1.............1..1.1...1
1.1.1111111.1111.1.11111
1P1.....1........1.....1
111111111111111111111111